S _ _ _ _ _
_ _ X X I _
_ _ F X _ _
_ _ _ X _ _
_ _ _ _ X _
W _ _ _ _ S